 pali bhashaa ke adhikansh shabdon kii sanskrit shabdon main bahut adhik samanta paayi jaati he. duusare shabdon main yon kahen ki pali shabd sanskrit shabdon se vyutpann se lagate hai. neeche kuch pramukh shabdon ke tulya pali shabd diye gayi hai-
 achyut -- achchut
 agni -- agg
 ahimsa -- ahimsa
 akshar -- akkhar
 amrit -- amat
 anatman -- anatt
 apramaad -- appamaad
 arya -- ariy
 atman -- att / attan
 rishi -- isi
 riddhi -- iddhi
 ruju -- uju
 vruddh - vuddh
 krit -- kat
 sthavir -- ther
 aushadh -- osdh
 rajya -- rajj
 ishwar -- issar
 teern -- tinn
 purv -- pubb
 sharan -- saran
 dosha -- dos
 bhikshu -- bhikkhu
 brahmacharin -- brahmacharin
 brahman -- brahman
 buddha -- buddha
 chakra -- chakk
 chandra -- chand
 chitra -- chitt
 chitt -- chitt
 drudh -- dalh
 dand -- dand
 darshan -- dassan
 dev -- dev
 dharm -- dhamm
 dharmasth -- dharmatth
 dhruv -- dhuv
 dukh -- dukh
 gandharv -- gandhabb
 gupt -- gutt
 hans -- hans
 dhyaan -- jhaan
 karm -- kamm
 kaam -- kaam
 skandh -- khandh
 shaanti -- khaanti / khanti
 kshatriya -- khattiye
 kshetra -- khett
 krodh -- kodh
 martya -- machch
 mrityu -- machchu
 maarg -- magg
 maitra -- metra 
 mithyaadrushti -- michhaditthi
 moksh -- mokh
 mukt -- mutt
 nirvana -- nibban
 nity -- nichch
 pravrajit -- pabbajit 
 prakirnak -- pakinnak 
 praan -- paan 
 pragna -- panna 
 pragnashila -- pannasila 
 parinirvana -- parinibban
 pratmoksha -- patimokh 
 priy -- piy 
 pushp -- pupf
 putr -- putt 
 sarv -- sabb 
 satya -- sachch
 shraddha -- saddha
 swarg -- sagg
 sahasr -- sahass 
 shraman -- saman 
 samyojan -- sannojan / sangyojan
 strothas -- sot 
 shukla -- sukk 
 shoonyata -- sunnata, the Void)
 trishna -- tanha 
 tripitak -- tipitak
 sutara -- sutt
 sthaan - thaan 
 vak / vach -- vach 
 varg -- vagg 
 vran -- van 
 van -- van )
 vijan -- vijan 
 vigyaan -- vinnan 
 veery -- viri 
 chatvaari aryasatyani -- chattari ariyascchani 
 1) dukh -- dukh
 2) samuday -- samuday 
 3) nirodh -- nirodh 
 4) maarg -- magg 
 1) samyagdrushti -- sammditthi 
 2) samyak sankalp -- sammsankapp 
 3) samyagvak -- sammvach 
 4) samyak karmant -- sammakammant 
 5) samyagjeev -- sammjeev 
 6) samyagvyaayaam -- sammavyam 
 7) samyaksmriti -- sammsati 
 8) samyaksamadhi -- sammsamadhi 
